11111111111111111111
10000000000000000001
10000000000000000001
10000000000000000001
10000000000000000001
10000000000000000001
10000000000000000001
10000000000000000001
10000000000000000001
10000000000000000081
10700000022222222221
10000000000000000001
12222200070000000001
10000000000000000001
10000002222200007001
10000000000000000001
10000000007000222221
10000000000000111111
10000022222222111111
12222211111111111111