11111111111111111111
10000000000000000001
10000000000000000001
10000000000000000001
10000000000000000001
17000000000000000081
10000000022222222221
10000000000000000071
12222220000000000001
10000000000000000001
10700000022222222221
10000000000000000001
10000002000007000001
10222000000000000001
10000002222200007001
10000000000020000001
10000000000000000001
10000000000007222221
10000022222222111111
12222211111111111111