11111111111111111111
10000000000000000001
10000000000000000081
10000200000000000221
10000000002200020001
10000000500022000001
10002220000000000001
12000000000000000001
10000000000000000001
10200000000000000001
10020020000300300001
10000000022222220001
10000000000000000001
10000000007070000201
10000000000000000001
10000000002020222221
10000022266666111111
10000211111111111111
10002111111111111111
12221111111111111111