10000000000000000001
10000000000000000001
10000000000000000001
10000000000000000001
10000000000000000001
10070000000000000001
12222222000000000001
10000000000000000081
10000000000022222221
10000000000000000001
10000022220000000001
10000000000000000001
10003000000000000001
12222222220000000001
10000000000000000001
10000000000000007001
10000000000222222001
10000000300000000001
10000003330000000001
12222222222222222221