10000000000000000001
10000000000000000081
10000000000002222221
10000000000000000001
10000000220000000001
10000000000000007001
10022000000000000001
10000000000000000001
10000000220000022001
10000000000000000001
12200000000266666661
10000000022111111111
10000000200000000001
10000000000000000001
10022220000222220001
16610002111100002001
11110000000000000001
10000000000000000021
10000300700703000001
12222222222222222221