10000000222200000001
10000000000022221001
10000002000000001001
10000000000000001001
10000000000000001001
10000002000000001001
10000000000200001001
10000000000000001001
10000000000000001001
10000000002222261001
10000000000000011001
10000026200000001001
10000001000000001001
16222000000000001001
11000000000000001001
10000000000000001001
10000022222222222001
10000000000000001001
10000000000000001781
12222222222222222221